delta_1d,delta_2d,delta_all,sum_doses,sum_1d,sum_2d,perc_doses,perc_inh_tot,perc_inh_1d,perc_inh_2d,sum_monotone_1d,sum_monotone_2d,perc_inh_monotone_1d,perc_inh_monotone_2d,date
0,0,0,0,0,0,0,0,0,0,0,0,0,0,2020-12-26
615,0,615,615,615,0,99.2,0.01666,0.01666,0.0,615,0,0.01666,0.0,2020-12-27
0,0,0,615,615,0,99.2,0.01666,0.01666,0.0,615,0,0.01666,0.0,2020-12-28
0,0,0,615,615,0,99.2,0.01666,0.01666,0.0,615,0,0.01666,0.0,2020-12-29
328,0,328,943,943,0,6.2,0.02554,0.02554,0.0,943,0,0.02554,0.0,2020-12-30
798,0,798,1741,1741,0,6.2,0.04715,0.04715,0.0,1741,0,0.04715,0.0,2020-12-31
2325,0,2325,4066,4066,0,14.6,0.11011,0.11011,0.0,4066,0,0.11011,0.0,2021-01-01
3454,0,3454,7520,7520,0,26.9,0.20365,0.20365,0.0,7520,0,0.20365,0.0,2021-01-02
3290,0,3290,10810,10810,0,38.7,0.29275,0.29275,0.0,10810,0,0.29275,0.0,2021-01-03
5002,0,5002,15812,15812,0,56.6,0.42821,0.42821,0.0,15812,0,0.42821,0.0,2021-01-04
5193,0,5193,21005,21005,0,66.0,0.56885,0.56885,0.0,21005,0,0.56885,0.0,2021-01-05
4467,0,4467,25472,25472,0,80.1,0.68982,0.68982,0.0,25472,0,0.68982,0.0,2021-01-06
5932,0,5932,31404,31404,0,60.1,0.85047,0.85047,0.0,31404,0,0.85047,0.0,2021-01-07
5855,0,5855,37259,37259,0,71.2,1.00903,1.00903,0.0,37259,0,1.00903,0.0,2021-01-08
4419,0,4419,41678,41678,0,79.7,1.1287,1.1287,0.0,41678,0,1.1287,0.0,2021-01-09
2947,0,2947,44625,44625,0,85.3,1.20851,1.20851,0.0,44625,0,1.20851,0.0,2021-01-10
4996,0,4996,49621,49621,0,94.9,1.34381,1.34381,0.0,49621,0,1.34381,0.0,2021-01-11
3508,0,3508,53129,53129,0,65.9,1.43881,1.43881,0.0,53129,0,1.43881,0.0,2021-01-12
3998,0,3998,57127,57127,0,66.5,1.54709,1.54709,0.0,57127,0,1.54709,0.0,2021-01-13
3219,0,3219,60346,60346,0,70.3,1.63426,1.63426,0.0,60346,0,1.63426,0.0,2021-01-14
3819,0,3819,64165,64165,0,74.7,1.73769,1.73769,0.0,64165,0,1.73769,0.0,2021-01-15
3213,0,3213,67378,67378,0,78.5,1.8247,1.8247,0.0,67378,0,1.8247,0.0,2021-01-16
1987,514,2501,69879,69365,514,81.4,1.89243,1.87851,0.01392,69365,514,1.87851,0.01392,2021-01-17
972,98,1070,70949,70337,612,78.4,1.92141,1.90483,0.01657,70337,612,1.90483,0.01657,2021-01-18
1064,0,1064,72013,71401,612,79.5,1.95022,1.93365,0.01657,71401,612,1.93365,0.01657,2021-01-19
1021,248,1269,73282,72422,860,75.1,1.98459,1.9613,0.02329,72422,860,1.9613,0.02329,2021-01-20
858,722,1580,74862,73280,1582,71.6,2.02738,1.98453,0.04284,73280,1582,1.98453,0.04284,2021-01-21
525,2338,2863,77725,73805,3920,74.3,2.10491,1.99875,0.10616,73805,3920,1.99875,0.10616,2021-01-22
634,3327,3961,81686,74439,7247,78.1,2.21218,2.01592,0.19626,74439,7247,2.01592,0.19626,2021-01-23
198,3149,3347,85033,74637,10396,81.3,2.30282,2.02128,0.28154,74637,10396,2.02128,0.28154,2021-01-24
241,4881,5122,90155,74878,15277,86.2,2.44153,2.02781,0.41372,74878,15277,2.02781,0.41372,2021-01-25
216,5173,5389,95544,75094,20450,74.6,2.58748,2.03366,0.55382,75094,20450,2.03366,0.55382,2021-01-26
201,4629,4830,100374,75295,25079,75.0,2.71828,2.0391,0.67918,75295,25079,2.0391,0.67918,2021-01-27
346,5930,6276,106650,75641,31009,79.7,2.88824,2.04847,0.83977,75641,31009,2.04847,0.83977,2021-01-28
292,5841,6133,112783,75933,36850,84.3,3.05434,2.05638,0.99795,75933,36850,2.05638,0.99795,2021-01-29
179,4426,4605,117388,76112,41276,87.7,3.17905,2.06123,1.11782,76112,41276,2.06123,1.11782,2021-01-30
102,2945,3047,120435,76214,44221,90.0,3.26156,2.06399,1.19757,76214,44221,2.06399,1.19757,2021-01-31
511,4988,5499,125934,76725,49209,91.3,3.41048,2.07783,1.33265,76725,49209,2.07783,1.33265,2021-02-01
189,3546,3735,129669,76914,52755,76.5,3.51163,2.08295,1.42869,76914,52755,2.08295,1.42869,2021-02-02
237,3981,4218,133887,77151,56736,79.0,3.62586,2.08937,1.5365,77151,56736,2.08937,1.5365,2021-02-03
934,3293,4227,138114,78085,60029,81.5,3.74034,2.11466,1.62568,78085,60029,2.11466,1.62568,2021-02-04
1890,3826,5716,143830,79975,63855,84.8,3.89513,2.16584,1.72929,79975,63855,2.16584,1.72929,2021-02-05
1262,3234,4496,148326,81237,67089,87.5,4.01689,2.20002,1.81687,81237,67089,2.20002,1.81687,2021-02-06
867,1921,2788,151114,82104,69010,89.1,4.0924,2.2235,1.8689,82104,69010,2.2235,1.8689,2021-02-07
3529,459,3988,155102,85633,69469,91.5,4.2004,2.31907,1.88133,85633,69469,2.31907,1.88133,2021-02-08
3764,611,4375,159477,89397,70080,73.7,4.31888,2.42101,1.89787,89397,70080,2.42101,1.89787,2021-02-09
3585,523,4108,163585,92982,70603,75.6,4.43013,2.51809,1.91204,92982,70603,2.51809,1.91204,2021-02-10
5061,242,5303,168888,98043,70845,78.0,4.57374,2.65515,1.91859,98043,70845,2.65515,1.91859,2021-02-11
7292,213,7505,176393,105335,71058,81.5,4.77699,2.85263,1.92436,105335,71058,2.85263,1.92436,2021-02-12
7411,227,7638,184031,112746,71285,75.4,4.98384,3.05333,1.93051,112746,71285,3.05333,1.93051,2021-02-13
8737,110,8847,192878,121483,71395,79.0,5.22343,3.28994,1.93349,121483,71395,3.28994,1.93349,2021-02-14
7771,826,8597,201475,129254,72221,82.5,5.45625,3.50039,1.95585,129254,72221,3.50039,1.95585,2021-02-15
8329,721,9050,210525,137583,72942,83.4,5.70134,3.72596,1.97538,137583,72942,3.72596,1.97538,2021-02-16
7303,752,8055,218580,144886,73694,86.6,5.91948,3.92373,1.99575,144886,73694,3.92373,1.99575,2021-02-17
7743,896,8639,227219,152629,74590,78.7,6.15344,4.13343,2.02001,152629,74590,4.13343,2.02001,2021-02-18
7599,513,8112,235331,160228,75103,73.5,6.37312,4.33922,2.0339,160228,75103,4.33922,2.0339,2021-02-19
3993,515,4508,239839,164221,75618,75.0,6.4952,4.44735,2.04785,164221,75618,4.44735,2.04785,2021-02-20
4731,170,4901,244740,168952,75788,76.5,6.62793,4.57548,2.05245,168952,75788,4.57548,2.05245,2021-02-21
9167,277,9444,254184,178119,76065,79.4,6.88369,4.82373,2.05996,178119,76065,4.82373,2.05996,2021-02-22
7212,161,7373,261557,185331,76226,71.8,7.08336,5.01905,2.06432,185331,76226,5.01905,2.06432,2021-02-23
10035,197,10232,271789,195366,76423,74.6,7.36046,5.29081,2.06965,195366,76423,5.29081,2.06965,2021-02-24
9465,998,10463,282252,204831,77421,77.4,7.64381,5.54713,2.09668,204831,77421,5.54713,2.09668,2021-02-25
8659,1206,9865,292117,213490,78627,80.2,7.91097,5.78163,2.12934,213490,78627,5.78163,2.12934,2021-02-26
1007,902,1909,294026,214497,79529,75.2,7.96267,5.8089,2.15377,214497,79529,5.8089,2.15377,2021-02-27
852,727,1579,295605,215349,80256,75.6,8.00543,5.83198,2.17345,215349,80256,5.83198,2.17345,2021-02-28
767,3641,4408,300013,216116,83897,74.9,8.12481,5.85275,2.27206,216116,83897,5.85275,2.27206,2021-03-01
7043,3444,10487,310500,223159,87341,69.4,8.40881,6.04348,2.36533,223159,87341,6.04348,2.36533,2021-03-02
14496,3606,18102,328602,237655,90947,73.4,8.89904,6.43606,2.46298,237655,90947,6.43606,2.46298,2021-03-03
14612,3082,17694,346296,252267,94029,77.3,9.37822,6.83177,2.54645,252267,94029,6.83177,2.54645,2021-03-04
11943,4755,16698,362994,264210,98784,81.0,9.83043,7.15521,2.67522,264210,98784,7.15521,2.67522,2021-03-05
2829,4197,7026,370020,267039,102981,82.6,10.0207,7.23182,2.78888,267039,102981,7.23182,2.78888,2021-03-06
1992,3545,5537,375557,269031,106526,83.8,10.17065,7.28577,2.88489,269031,106526,7.28577,2.88489,2021-03-07
1844,4821,6665,382222,270875,111347,85.2,10.35115,7.33571,3.01545,270875,111347,7.33571,3.01545,2021-03-08
5506,5553,11059,393281,276381,116900,78.8,10.65065,7.48482,3.16583,276381,116900,7.48482,3.16583,2021-03-09
14256,4018,18274,411555,290637,120918,76.2,11.14553,7.87089,3.27464,290637,120918,7.87089,3.27464,2021-03-10
12395,3333,15728,427283,303032,124251,79.1,11.57147,8.20657,3.36491,303032,124251,8.20657,3.36491,2021-03-11
13266,3527,16793,444076,316298,127778,82.1,12.02625,8.56583,3.46042,316298,127778,8.56583,3.46042,2021-03-12
5171,3964,9135,453211,321469,131742,81.5,12.27364,8.70587,3.56777,321469,131742,8.70587,3.56777,2021-03-13
3148,3935,7083,460294,324617,135677,82.7,12.46546,8.79112,3.67434,324617,135677,8.79112,3.67434,2021-03-14
4085,4444,8529,468823,328702,140121,77.2,12.69644,8.90175,3.79469,328702,140121,8.90175,3.79469,2021-03-15
2567,2253,4820,473643,331269,142374,78.0,12.82697,8.97127,3.8557,331269,142374,8.97127,3.8557,2021-03-16
6800,4529,11329,484972,338069,146903,79.9,13.13378,9.15542,3.97836,338069,146903,9.15542,3.97836,2021-03-17
5868,3973,9841,494813,343937,150876,81.5,13.40029,9.31434,4.08595,343937,150876,9.31434,4.08595,2021-03-18
7128,2867,9995,504808,351065,153743,83.2,13.67097,9.50737,4.16359,351065,153743,9.50737,4.16359,2021-03-19
5362,1136,6498,511306,356427,154879,84.2,13.84694,9.65258,4.19436,356427,154879,9.65258,4.19436,2021-03-20
1819,1433,3252,514558,358246,156312,84.8,13.93501,9.70185,4.23317,358246,156312,9.70185,4.23317,2021-03-21
4675,446,5121,519679,362921,156758,76.2,14.0737,9.82845,4.24524,362921,156758,9.82845,4.24524,2021-03-22
6964,2276,9240,528919,369885,159034,77.6,14.32393,10.01705,4.30688,369885,159034,10.01705,4.30688,2021-03-23
10420,9460,19880,548799,380305,168494,80.4,14.86231,10.29924,4.56307,380305,168494,10.29924,4.56307,2021-03-24
15299,8356,23655,572454,395604,176850,81.9,15.50292,10.71356,4.78937,395604,176850,10.71356,4.78937,2021-03-25
14717,5767,20484,592938,410321,182617,84.8,16.05766,11.11212,4.94555,410321,182617,11.11212,4.94555,2021-03-26
8512,216,8727,601665,418833,182833,86.0,16.294,11.34263,4.9514,418833,182833,11.34263,4.9514,2021-03-27
5875,254,6129,607794,424708,183087,86.9,16.45999,11.50174,4.95827,424708,183087,11.50174,4.95827,2021-03-28
9219,348,9567,617361,433927,183435,79.7,16.71907,11.7514,4.9677,433927,183435,11.7514,4.9677,2021-03-29
13266,3569,16835,634196,447193,187004,81.9,17.17499,12.11067,5.06435,447193,187004,12.11067,5.06435,2021-03-30
20213,12172,32385,666581,467406,199176,86.0,18.05203,12.65806,5.39399,467406,199176,12.65806,5.39399,2021-03-31
16162,10676,26838,693419,483568,209852,89.5,18.77884,13.09576,5.68311,483568,209852,13.09576,5.68311,2021-04-01
23708,8030,31738,725157,507276,217882,89.5,19.63835,13.7378,5.90058,507276,217882,13.7378,5.90058,2021-04-02
13674,1126,14800,739957,520950,219008,83.6,20.03916,14.10812,5.93107,520950,219008,14.10812,5.93107,2021-04-03
13508,254,13762,753719,534458,219262,85.1,20.41186,14.47393,5.93795,534458,219262,14.47393,5.93795,2021-04-04
14369,737,15106,768825,548827,219999,86.8,20.82095,14.86307,5.95791,548827,219999,14.86307,5.95791,2021-04-05
18090,3720,21810,790635,566917,223719,79.3,21.4116,15.35297,6.05865,566917,223719,15.35297,6.05865,2021-04-06
28160,7251,35411,826046,595077,230970,82.9,22.37058,16.11559,6.25502,595077,230970,16.11559,6.25502,2021-04-07
22941,6388,29329,855375,618018,237358,85.8,23.16485,16.73687,6.42802,618018,237358,16.73687,6.42802,2021-04-08
20750,3410,24160,879535,638768,240768,88.2,23.81914,17.29881,6.52036,638768,240768,17.29881,6.52036,2021-04-09
10757,744,11501,891036,649525,241512,89.4,24.13061,17.59012,6.54051,649525,241512,17.59012,6.54051,2021-04-10
3336,158,3491,894527,652861,241670,89.7,24.22515,17.68047,6.54479,652861,241670,17.68047,6.54479,2021-04-11
1799,655,2454,896981,654660,242325,88.1,24.29161,17.72919,6.56253,654660,242325,17.72919,6.56253,2021-04-12
5748,2458,8206,905187,660408,244783,88.4,24.51384,17.88485,6.6291,660408,244783,17.88485,6.6291,2021-04-13
14532,5115,19646,924833,674940,249898,82.7,25.04588,18.2784,6.76762,674940,249898,18.2784,6.76762,2021-04-14
15301,8582,23883,948716,690241,258480,84.5,25.69267,18.69278,7.00003,690241,258480,18.69278,7.00003,2021-04-15
21417,6906,28323,977039,711658,265386,87.0,26.4597,19.27278,7.18706,711658,265386,19.27278,7.18706,2021-04-16
17913,2139,20052,997091,729571,267525,88.8,27.00274,19.75789,7.24498,729571,267525,19.75789,7.24498,2021-04-17
7056,1029,8085,1005176,736627,268554,89.5,27.22169,19.94898,7.27285,736627,268554,19.94898,7.27285,2021-04-18
7750,1032,8782,1013958,744377,269586,87.9,27.45952,20.15886,7.3008,744377,269586,20.15886,7.3008,2021-04-19
12212,5585,17797,1031755,756589,275171,89.4,27.94149,20.48958,7.45205,756589,275171,20.48958,7.45205,2021-04-20
16854,12134,28988,1060743,773443,287305,83.3,28.72653,20.94601,7.78066,773443,287305,20.94601,7.78066,2021-04-21
17386,17495,34881,1095624,790829,304800,85.3,29.67116,21.41685,8.25445,790829,304800,21.41685,8.25445,2021-04-22
8809,16322,25131,1120755,799638,321122,87.2,30.35175,21.65541,8.69647,799638,321122,21.65541,8.69647,2021-04-23
5619,7449,13067,1133822,805257,328571,88.2,30.70562,21.80758,8.8982,805257,328571,21.80758,8.8982,2021-04-24
8757,8518,10900,1144722,814014,337089,89.1,31.00081,22.04474,9.12888,814014,337089,22.04474,9.12888,2021-04-25
7454,6798,10010,1154732,821468,343887,88.3,31.2719,22.2466,9.31298,821468,343887,22.2466,9.31298,2021-04-26
3663,6496,10154,1164886,825131,350383,89.1,31.54688,22.3458,9.4889,825131,350383,22.3458,9.4889,2021-04-27
3460,15333,18775,1183661,828591,365716,82.4,32.05534,22.4395,9.90414,828591,365716,22.4395,9.90414,2021-04-28
18571,20100,38671,1222332,847162,385816,85.1,33.10261,22.94243,10.44848,847162,385816,22.94243,10.44848,2021-04-29
19662,19910,39572,1261904,866824,405726,87.9,34.17428,23.47491,10.98768,866824,405726,23.47491,10.98768,2021-04-30
13740,9207,22946,1284850,880564,414933,81.6,34.79569,23.84701,11.23702,880564,414933,23.84701,11.23702,2021-05-01
8978,1966,10944,1295794,889542,416899,82.3,35.09207,24.09015,11.29026,889542,416899,24.09015,11.29026,2021-05-02
10363,1324,11685,1307479,899905,418223,83.0,35.40852,24.37079,11.32611,899905,418223,24.37079,11.32611,2021-05-03
12415,5455,17870,1325349,912320,423678,84.2,35.89246,24.70701,11.47384,912320,423678,24.70701,11.47384,2021-05-04
14863,14529,29392,1354741,927183,438207,79.7,36.68844,25.10952,11.86731,927183,438207,25.10952,11.86731,2021-05-05
13468,17211,30674,1385415,940651,455418,81.5,37.51914,25.47426,12.33341,940651,455418,25.47426,12.33341,2021-05-06
11362,22283,31543,1416958,952013,477701,82.3,38.37338,25.78196,12.93687,952013,477701,25.78196,12.93687,2021-05-07
13278,19180,28752,1445710,965291,496881,84.0,39.15202,26.14155,13.45629,965291,496881,26.14155,13.45629,2021-05-08
9414,14455,22276,1467986,974705,511336,85.3,39.75529,26.39649,13.84776,974705,511336,26.39649,13.84776,2021-05-09
15237,11539,25871,1493857,989942,522875,86.8,40.45592,26.80913,14.16025,989942,522875,26.80913,14.16025,2021-05-10
12102,16067,27574,1521431,1002044,538942,88.4,41.20266,27.13687,14.59537,1002044,538942,27.13687,14.59537,2021-05-11
13583,20038,33621,1555052,1015627,558980,84.3,42.11317,27.50472,15.13803,1015627,558980,27.50472,15.13803,2021-05-12
13202,21312,34503,1589555,1028829,580292,86.1,43.04756,27.86225,15.71519,1028829,580292,27.86225,15.71519,2021-05-13
20022,12829,32731,1622286,1048851,593121,86.6,43.93397,28.40448,16.06262,1048851,593121,28.40448,16.06262,2021-05-14
22865,5894,28759,1651045,1071716,599015,88.2,44.71281,29.0237,16.22224,1071716,599015,29.0237,16.22224,2021-05-15
23917,2484,26386,1677431,1095633,601499,89.6,45.42738,29.67141,16.28951,1095633,601499,29.67141,16.28951,2021-05-16
20557,8939,29491,1706922,1116190,610438,91.1,46.22604,30.22812,16.53159,1116190,610438,30.22812,16.53159,2021-05-17
19759,8826,28585,1735507,1135949,619264,92.7,47.00017,30.76322,16.77061,1135949,619264,30.76322,16.77061,2021-05-18
18644,9057,27701,1763208,1154593,628321,88.3,47.75035,31.26813,17.01589,1154593,628321,31.26813,17.01589,2021-05-19
18639,11433,29486,1792694,1173232,639754,89.8,48.54888,31.77291,17.32551,1173232,639754,31.77291,17.32551,2021-05-20
17222,12458,28670,1821364,1190454,652212,89.6,49.3253,32.2393,17.66289,1190454,652212,32.2393,17.66289,2021-05-21
21486,9143,25776,1847140,1211940,661355,90.9,50.02336,32.82118,17.9105,1211940,661355,32.82118,17.9105,2021-05-22
25592,4654,28152,1875292,1237532,666009,92.3,50.78576,33.51425,18.03654,1237532,666009,33.51425,18.03654,2021-05-23
23887,9582,33469,1908761,1261419,675591,92.1,51.69215,34.16114,18.29603,1261419,675591,34.16114,18.29603,2021-05-24
19282,14633,33914,1942675,1280701,690224,93.7,52.61059,34.68333,18.69231,1280701,690224,34.68333,18.69231,2021-05-25
20137,15209,35346,1978021,1300838,705433,89.9,53.56781,35.22867,19.1042,1300838,705433,35.22867,19.1042,2021-05-26
13272,14879,28136,2006157,1314110,720312,91.2,54.32978,35.5881,19.50714,1314110,720312,35.5881,19.50714,2021-05-27
17425,13244,29902,2036059,1331535,733556,92.5,55.13957,36.05999,19.86581,1331535,733556,36.05999,19.86581,2021-05-28
23177,12977,31345,2067404,1354712,746533,93.9,55.98844,36.68766,20.21725,1354712,746533,36.68766,20.21725,2021-05-29
21503,9543,28452,2095856,1376215,756076,92.7,56.75896,37.26999,20.47569,1376215,756076,37.26999,20.47569,2021-05-30
19261,11094,30089,2125945,1395476,767170,94.0,57.57382,37.79161,20.77613,1395476,767170,37.79161,20.77613,2021-05-31
22871,4635,26705,2152650,1418347,771805,87.4,58.29703,38.41099,20.90165,1418347,771805,38.41099,20.90165,2021-06-01
21860,6052,27368,2180018,1440207,777857,88.5,59.0382,39.00299,21.06555,1440207,777857,39.00299,21.06555,2021-06-02
27151,7444,31734,2211752,1467358,785301,89.8,59.8976,39.73828,21.26714,1467358,785301,39.73828,21.26714,2021-06-03
20262,9789,28061,2239813,1487620,795090,87.2,60.65754,40.28701,21.53225,1487620,795090,40.28701,21.53225,2021-06-04
20563,10422,28178,2267991,1508183,805512,88.3,61.42064,40.84389,21.81449,1508183,805512,40.84389,21.81449,2021-06-05
22588,5855,27953,2295944,1530771,811367,88.6,62.17765,41.4556,21.97305,1530771,811367,41.4556,21.97305,2021-06-06
30973,4519,34620,2330564,1561744,815886,90.0,63.11521,42.2944,22.09543,1561744,815886,42.2944,22.09543,2021-06-07
31750,1809,32239,2362803,1593494,817695,91.2,63.9883,43.15424,22.14442,1593494,817695,43.15424,22.14442,2021-06-08
33952,2332,34415,2397218,1627446,820027,86.7,64.92031,44.07371,22.20758,1627446,820027,44.07371,22.20758,2021-06-09
25513,3124,26059,2423277,1652959,823151,87.6,65.62602,44.76464,22.29218,1652959,823151,44.76464,22.29218,2021-06-10
24738,6488,29395,2452672,1677697,829639,88.4,66.42208,45.43458,22.46788,1677697,829639,45.43458,22.46788,2021-06-11
24660,6316,29049,2481721,1702357,835955,89.4,67.20878,46.10241,22.63893,1702357,835955,46.10241,22.63893,2021-06-12
22608,1817,24267,2505988,1724965,837772,90.3,67.86596,46.71467,22.68814,1724965,837772,46.71467,22.68814,2021-06-13
27412,4298,31520,2537508,1752377,842070,90.7,68.71957,47.45703,22.80454,1752377,842070,47.45703,22.80454,2021-06-14
26301,4748,30873,2568381,1778678,846818,91.8,69.55566,48.1693,22.93312,1778678,846818,48.1693,22.93312,2021-06-15
26269,6087,31449,2599830,1804947,852905,86.3,70.40735,48.88071,23.09796,1804947,852905,48.88071,23.09796,2021-06-16
26684,6563,32230,2632060,1831631,859468,87.3,71.28018,49.60335,23.2757,1831631,859468,49.60335,23.2757,2021-06-17
24999,6092,30403,2662463,1856630,865560,88.3,72.10354,50.28036,23.44068,1856630,865560,50.28036,23.44068,2021-06-18
21393,5035,26179,2688642,1878023,870595,89.2,72.81251,50.85972,23.57704,1878023,870595,50.85972,23.57704,2021-06-19
15424,9787,24941,2713583,1893447,880382,88.8,73.48795,51.27742,23.84208,1893447,880382,51.27742,23.84208,2021-06-20
18145,12846,30937,2744520,1911592,893228,89.8,74.32577,51.76882,24.18997,1911592,893228,51.76882,24.18997,2021-06-21
22442,8285,30653,2775173,1934034,901513,90.8,75.1559,52.37658,24.41434,1934034,901513,52.37658,24.41434,2021-06-22
19797,11679,31176,2806349,1953831,913192,84.9,76.00019,52.91271,24.73063,1953831,913192,52.91271,24.73063,2021-06-23
19306,10144,29049,2835398,1973137,923336,85.3,76.78689,53.43555,25.00534,1973137,923336,53.43555,25.00534,2021-06-24
12109,21424,33352,2868750,1985246,944760,86.3,77.69011,53.76348,25.58554,1985246,944760,53.76348,25.58554,2021-06-25
9993,24340,34317,2903067,1995239,969100,86.5,78.61947,54.0341,26.2447,1995239,969100,54.0341,26.2447,2021-06-26
5920,27256,33171,2936238,2001159,996356,87.5,79.51779,54.19443,26.98283,2001159,996356,54.19443,26.98283,2021-06-27
8437,29122,37512,2973750,2009596,1025478,88.6,80.53367,54.42291,27.7715,2009596,1025478,54.42291,27.7715,2021-06-28
7984,28984,36876,3010626,2017580,1054462,89.7,81.53233,54.63913,28.55643,2017580,1054462,54.63913,28.55643,2021-06-29
8454,29815,38042,3048668,2026034,1084277,85.2,82.56256,54.86808,29.36387,2026034,1084277,54.86808,29.36387,2021-06-30
10723,21320,31779,3080447,2036757,1105597,86.1,83.42319,55.15847,29.94125,2036757,1105597,55.15847,29.94125,2021-07-01
10820,17468,28011,3108458,2047577,1123065,85.4,84.18177,55.4515,30.41431,2047577,1123065,55.4515,30.41431,2021-07-02
11859,17175,29019,3137477,2059436,1140240,86.2,84.96764,55.77266,30.87943,2059436,1140240,55.77266,30.87943,2021-07-03
9370,21982,31230,3168707,2068806,1162222,85.3,85.8134,56.02641,31.47474,2068806,1162222,56.02641,31.47474,2021-07-04
10341,20357,30283,3198990,2079147,1182579,86.1,86.63351,56.30646,32.02604,2079147,1182579,56.30646,32.02604,2021-07-05
11038,14753,25557,3224547,2090185,1197332,86.7,87.32563,56.60539,32.42557,2090185,1197332,56.60539,32.42557,2021-07-06
9338,16326,25450,3249997,2099523,1213658,84.7,88.01486,56.85827,32.8677,2099523,1213658,56.85827,32.8677,2021-07-07
9252,12029,20815,3270812,2108775,1225687,85.3,88.57856,57.10883,33.19347,2108775,1225687,57.10883,33.19347,2021-07-08
7697,21393,28926,3299738,2116472,1247080,86.0,89.36192,57.31728,33.77282,2116472,1247080,57.31728,33.77282,2021-07-09
7955,21320,29112,3328850,2124427,1268400,86.2,90.15032,57.53271,34.3502,2124427,1268400,57.53271,34.3502,2021-07-10
9131,17258,25954,3354804,2133558,1285658,86.8,90.85319,57.77999,34.81757,2133558,1285658,57.77999,34.81757,2021-07-11
9668,18307,27968,3382772,2143226,1303965,87.6,91.61061,58.04182,35.31335,2143226,1303965,58.04182,35.31335,2021-07-12
7714,21595,29158,3411930,2150940,1325560,88.3,92.40025,58.25072,35.89818,2150940,1325560,58.25072,35.89818,2021-07-13
8580,20090,28575,3440505,2159520,1345650,86.4,93.1741,58.48308,36.44225,2159520,1345650,58.48308,36.44225,2021-07-14
8079,23171,30971,3471476,2167599,1368821,87.2,94.01284,58.70187,37.06975,2167599,1368821,58.70187,37.06975,2021-07-15
7706,20255,27411,3498887,2175305,1389076,87.8,94.75518,58.91056,37.61829,2175305,1389076,58.91056,37.61829,2021-07-16
8964,18746,27501,3526388,2184269,1407822,88.5,95.49995,59.15332,38.12596,2184269,1407822,59.15332,38.12596,2021-07-17
8336,21819,30155,3556543,2192605,1429641,88.6,96.31659,59.37907,38.71685,2192605,1429641,59.37907,38.71685,2021-07-18
8839,28941,37733,3594276,2201444,1458582,89.6,97.33846,59.61845,39.50062,2201444,1458582,59.61845,39.50062,2021-07-19
7960,29258,37093,3631369,2209404,1487840,89.7,98.34299,59.83402,40.29297,2209404,1487840,59.83402,40.29297,2021-07-20
7331,31031,38225,3669594,2216735,1518871,88.1,99.37818,60.03255,41.13333,2216735,1518871,60.03255,41.13333,2021-07-21
4497,34838,39142,3708736,2221232,1553709,89.0,100.43821,60.15434,42.0768,2221232,1553709,60.15434,42.0768,2021-07-22
4396,33950,38260,3746996,2225628,1587659,89.9,101.47434,60.27339,42.99622,2225628,1587659,60.27339,42.99622,2021-07-23
6855,31362,38193,3785189,2232483,1619021,90.8,102.50867,60.45903,43.84555,2232483,1619021,60.45903,43.84555,2021-07-24
7061,26654,33710,3818899,2239544,1645675,91.6,103.42159,60.65025,44.56738,2239544,1645675,60.65025,44.56738,2021-07-25
10085,28089,37918,3856817,2249629,1673764,91.9,104.44846,60.92337,45.32807,2249629,1673764,60.92337,45.32807,2021-07-26
11280,27217,38316,3895133,2260909,1700981,92.8,105.48612,61.22885,46.06515,2260909,1700981,61.22885,46.06515,2021-07-27
12094,26280,38158,3933291,2273003,1727261,90.4,106.5195,61.55637,46.77685,2273003,1727261,61.55637,46.77685,2021-07-28
12611,26707,38985,3972276,2285614,1753968,91.3,107.57527,61.8979,47.50012,2285614,1753968,61.8979,47.50012,2021-07-29
10773,27235,37458,4009734,2296387,1781203,92.2,108.58969,62.18965,48.23768,2296387,1781203,62.18965,48.23768,2021-07-30
12357,23255,35327,4045061,2308744,1804458,93.0,109.5464,62.5243,48.86746,2308744,1804458,62.5243,48.86746,2021-07-31
13797,15981,29426,4074487,2322541,1820439,93.7,110.3433,62.89794,49.30025,2322541,1820439,62.89794,49.30025,2021-08-01
9025,15374,72845,4147332,2331566,1835813,94.6,112.31605,63.14235,49.71661,2331566,1835813,63.14235,49.71661,2021-08-02
12579,23812,36384,4183716,2344145,1859625,95.5,113.30139,63.48301,50.36147,2344145,1859625,63.48301,50.36147,2021-08-03
10927,23526,34408,4218124,2355072,1883151,93.6,114.23321,63.77893,50.99859,2355072,1883151,63.77893,50.99859,2021-08-04
